사원번호,1월 급여,2월 급여,3월 급여, 1분기 급여 합계, 1분기 급여 평균,1분기 급여 합계,1분기 급여 평균
11,328,333,348,1009,336.3333333333333,1009,336.33
12,336,329,392,1057,352.3333333333333,1057,352.33
13,317,365,394,1076,358.6666666666667,1076,358.67
14,389,373,312,1074,358.0,1074,358.0
15,325,329,342,996,332.0,996,332.0
16,311,316,328,955,318.3333333333333,955,318.33
17,349,385,391,1125,375.0,1125,375.0
18,325,377,395,1097,365.6666666666667,1097,365.67
19,330,364,395,1089,363.0,1089,363.0
20,353,396,316,1065,355.0,1065,355.0
